R   1920 1080


SO  ./textures/bricks.XPM


NO  ./textures/stone.XPM


WE  ./textures/mossystone.XPM

EA  ./textures/concrete.XPM

S   ./textures/pillar.XPM




F   20,120,20




C     0,100, 200


1 1 1 1 1 1 1 1 1 1 1 1 1 1 1 1 1 1 1 1 1 1 1 1 1 1 1 1 1
1 0 0    0     0 0  0     0   0 0 1 1 0 0 0   0 0   0 0 0   0   0 0 0 0 0 0 0 1
1 0 1 1 0 0 0   0 0 1 1      1 0    0 0 0 0 0 0   1 1 1 0   0 1 0 0 0 1
1 0 0 1 0 0 0 0 0 0 0 0  0 0 1  1 1 1 1 1   0 0 0 0 1 0 2 0 1
1 0 1 1 0 0  0 0 0 1 1  1 0 0 1 0  0 1 0 1 0    0 0 0    1 0 0 0 1
1 0 0 0 0 0 0 0 0 0 1  1 0 0 0 0   0 1 1 1 0  1  1   1 1 0 0 0 1
1 1 1 1 0 1 1 1 1 1 1   1 1 1 0 1  0 1 0 0 0 0 0 0  1 0 0 0 1
1 1 1 1 0 1 1 1 1 1 1  1 1 1 0 1      0 0 0 1 0 1 0 0 1 0 0 0 1
1 1 0 0 0 0  0 0 1 1 0  1 0 1 0 1 1 1 0 0 0 0 0 0 1 0 0 0 1
1 0 0 0 2 0   0 0 0 0 0 0 0 0 0 0 1 1 0 0 0 0 0 0 1 0 0 0 1
1 0 0 0 0 0 0      0 0 0 0 0 0 0 0 0 1 1 0 1 0 1 0 0 1 0 0 0 1
1 1 0 0 0 0 0 0 1      1 0 1 0 1 0 1 1 1 1 1 0 1 1 1 1 0 E 0 1
1 1 1 1 0 1 1 1 1 1 1     1 0 1 0 1   1   1   1   1   0   1   1   1  1 0 0 2 1
1 1 1 1 1 1 1 1 1 1 1 1 1 1 1 1 1 1 1 1 1 1 1 1 1 1 1 1 1
