R   1000 1000

SO  ./textures/bricks.xpm
NO  ./textures/wood.xpm
WE  ./textures/dirt.xpm
EA  ./textures/stone.xpm
S   ./textures/unicorn.xpm

F   0, 100, 0
C   30, 140, 255

111111
100001
1000N1
111111
